MTTPTTTTRTTTDTTTTTTTTTRTTTTVTTTM
TTTTTVTTTDTTVTTTTTTTTTTTTDTTTTTM
TTTTTTTTRTTTTTTTTTTVTTTRTTTTTTTM
TTTTTTTTTTTTVTTTTTTTTTTTTTTTVTTM
TTTTTTTTRTTTTTTTTTTVTTTRTTTTTTTM
TTTTTTTTTTTTVTTTTTTTTTTTTTTTVTTM
MTTTTTTTVTTTTTTTTTTTTTDTTTTTTTTT
MTTTTTTTRTTTTTTTVTTTRTTTTTTTTTTT
MTTTTTTTTTTTTTRTTTTTTTTTTDTTTTTT
MTTTTTTTTVTTTTTTTTTTVTTTTTTTTTTT
MTTTTRTTTTTTTDTTTRTTTTDTTTTTTTTT
MTTVTTTTTTTTTTTTTTTTTTTTTTVTTTTT
MTTTTTTTTTRTTTTTTVTTTTTTTTTTTTTT
MTTTTTTVTTTTTDTTTTTTTRTTTTTTTTTM
MTTTTTTTRTTTTTTVTTTTTDTTTTTVTTTM
MMMMMMMMMMMMMMMMMMMMMMMTTTTTMMMM