BBBBBBBBBBBBBBBBBBBBBBBBBBBBBBBB
BBBBBBBBBBBBBBBBBBBBBBBBBBBBBBBB
BBBBBBBBBBBBBBBBBBBBBBBBBBBBBBBB
BBWWBBBBBBWWBBWWBBWWBBBBBWWBBWWB
BBWWBBBBBBWWBBWWBBWWBBBBBWWBBWWB
BBWWBBWWBBWWBBBBBBWWWWBBBWWBBWWB
BBWWBBWWBBWWBBWWBBWWWWBBBWWBBWWB
BBWWBBWWBBWWBBWWBBWWBBWWBWWBBWWB
BBWWBBWWBBWWBBWWBBWWBBWWBWWBBWWB
BBWWWWBBWWWWBBWWBBWWBBBBWWWBBWWB
BBWWWWBBWWWWBBWWBBWWBBBBWWWBBBBB
BBWWBBBBBBWWBBWWBBWWBBBBBWWBBWWB
BBWWBBBBBBWWBBWWBBWWBBBBBWWBBWWB
BBBBBBBBBBBBBBBBBBBBBBBBBBBBBBBB
BBBBBBBBBBBBBBBBBBBBBBBBBBBBBBBB
BBBBBBBBBBBBBBBBBBBBBBBBBBBBBBBB