MMMMMMMMMMMMMMMMMMMMMMMMMMMMMMMM
MTTTTTTTTTTTRVTTTTTTTTTTTTTTTTTM
MTTPTTTTRTTTDTTTTTTTTTRTTTTVTTTM
MTTTDDDTTDTTVTTTTTTTTTTTTDTTTTTM
MTTTDDDTRTTTTTTTTTTVTTTRTTTTTTTM
MTTTDDDTTTTTVTTTTTTTTTTTTTTTVTTM
MTTTDDDTVTTTTTTTTTTTTTDTTTTTTTTM
MTTTDDDTRTTTTTTTVTTTRTTTTTTTTTTM
MTTTDDDTTTTTTTRTTTTTTTTTTDTTTTTM
MTTTTTTTTVTTTTTTTTTTVTTTTTTTTTTM
MTTTTRTTTTTTTDTTTRTTTTDTTTTTTTTM
MTTVTTTTTTTTTTTTTTTTTTTTTTVTTTTM
MTTTTTTTTTRTTTTTTVTTTTTTTTTTTTTM
MTTTTTTVTTTTTDTTTTTTTRTTTTTTTTTM
MTTTTTTTRTTTTTTVTTTTTDTTTTTVTTTM
MMMMMMMMMMMMMMMMMMMMMMMMMMMMMMMM